    #####
    #   #
  ###t  #
  #    t##
###  t t #
#   # ## #   ######
#   # ## #####  pp#
# t  t          pp#
##### ### #@##  pp#
    #     #########
    #######
