 ###   #######
##@#####  ppp#
# tt t t   pp#
#  # # #   ###
#  t   #####
# #### #
#      #
########
