#########
#   # pp#
# tt# pp#
# t     #
#  t#   #
#@  #   #
#########
