  #####
  #   # ##########
  # # ###        #
  #       t   @  #
  # ##### tt  t  #
  # #   #        #
  # #   ##########
 ## #  
 #  ##
 #  p##
 #p pp#
 #    #
 #    #
 ######
