  #####
  #   #
###t# ###
#  @    #
# # ### #
#       #
####### ##
#p       #
#p       #
####### ##
      # #
##### # ###
#   # #   #
# # ### # #
# t       #
##### # ###
    #   #
    #####
